EEEEEEEEEEEEEEEEEEEEEEE
EEEEEEEEEEEEGGEEEEEEEEE
EEEEEEEEEEEEGGEEEEEEEEE
EEEEEEEEEEEEGGEEEEEEEEE
EEEEEEEEEEEEGGEEEEEEEEE
E$$EEEEEEEEKGGEEEEEEEEE
EEEEEEEGBBGGBBGEEEEEEFE
EEEEEEEGBBGGBBGEEESSSSS
EEEEEEEGGGGGGGGEEEGGGGG
EEEEEEEGGGGGGGGEEEGGGGG
E$$EEEEEEEEEEEEEEEGGGGG
EEEEEEEEEEEEEEEEEEEEBBB
EEEEEEEEoEEEEEEEEEEEBBB
SSS$$0$$EEEEEEEEEEEEEEE
BBBEEEEEEEE$$$EEEEEEEEE
BBBEEEEEEEEEE$$$EEEEBBB
BBBEEEEEEEEEEEEEEEEEBBB
BBBEEEEEEEEEEEEEEEGGGGG
EEEEEEEEEEKKKKKKKKGGGGG
EEEEGGGGGGGGGGGGGGGGGGG
EE1EGGGGGGGGGGGGGGGGGGG
SSSSGGGGGGGGGGGGGGGGGGG
EEEEEEEEEEEEEEEEEEEEEEE
