EEEEEEEEEEEEEEEEEEEEEEE
EEEEEEEEEEEEEEEEEEEEEEE
EEEEEEEEEEEEEEEEEEEEEEE
SSSSSSSSSSSEEEEEEEEEEEE
GGEEEEEEEGGEEEEEEEEEEEE
GGEEEEEEEGGEEEEEEEEEEEE
GGE1EEEEEGGEEEEEEEEEEEE
SSSSSSSESSSEEEEEEEEEEEE
GGEEEEE2EGGEEEEEEEEEEEE
GGEEEEEEEGGEEEEEEEEEEEE
GGEEEEEEEGGEEEEEEEEEEEE
SSEESSSSSSSEEEEEEEEEEEE
GG33GGGGGGGEEEFEEEEEEEE
GGEEGGGGGGGEEESEEEEBBBE
GGEEEEEEEEESEEEEESEEEEE
GGEEEEEEEEESBBBBBSEEEEE
GGEEEEEEEESSBBBBBSSEEEE
GGEEEEEEEEEEEEEEEEEEEEE
GGEEEEEEEEEEEEEEEEEEEEE
GGEEEEEEEEEEEEEEEEEEEEE
GGPPEEEEEEEEEEEEEEEEEGG
GGGGGGGGGGGGGPGGPGGGGGG
GGGGGGGGGGGGGSGGSGGGGGG
