EEEEEEEEEEEEEEEEEEEEEEE
EEEEEEEEEEEEEEEEEEEEEEE
EEEEEEEEEEEEEEEEEEESEEE
EEEEEEE$$$$EEEEEEEES$$$
EEEEEEEEEEEEEEEEEEES$$$
E1EEKEEEEEEEEEEEEEES$$$
SSSSSSSKKKKSSSSSPPPSEEE
EEEEEESSSSSSEEESSSSSEEE
EEEEEEEEEEEEEEEEEEEEEEE
EEEEEEEEEEEEEEEEEEEEEEE
EEEEESEEEEEEEEEEEEEEEEE
E$$EESEEEEEEEEEEEEEEEEE
EE$$ESEEEEEEEEEEEEEEEEE
E$$EESKKKKKKEEEEEEEPPPP
EE$$ESSSSSSSSSSSSSSSSSS
E$$EEEEEEEEEEEEEEEEEEEE
EE$$EEEE$$$EEEE$$$EEEEE
EEEEEEEEEEEEEEEEEEEEEEE
EEEEEEEEEEEEEEEEEEEEEEE
EEEEEEEEEEEEEEEEEEEEEEE
PPPPKKKKPPPKKKKPPPEEFEE
GGGGGGGGGGGGGGGGGGGSSSG
GGGGGGGGGGGGGGGGGGGGGGG
