EEEEEEEEEEEEEEEEEEEEEEE
EEEEEEEEEEEEEEEEEEEEEEE
EEEEEEEEEEEEEEEEEEEEEEE
EEEEEEEEEEEEEEEEEEEEEEE
EEEEEEEEEEEEEEEEEEEEEEE
EEEEEEEEEEEEEEEEEEEEEEE
EEEEEEEEEEEEEEEEEEEEEEE
EEEEEEEEEEEEEEEEEEEEEEE
EEEEEEEEEEEEEEEEEEEEEEE
EEEEEEEEEEEEEEEEEEEEEEE
EEEEEEEEEEEEEEEEEEEEEEE
EEEEEEEEEEEEEEEEEEEEEEE
EEEEEEEEEEEEEEEEEEEEEEE
EEEEEEE$$$EEEEEEEEEEEEE
EEEEEEEEEEEEEEEEEEEEEEE
EEEEEEEEEEEEEEEEEEEEEEE
EEEEEEEEEEEEEEEEEEEEEEE
1EEEEEEKKKEEEEEEEEEEEEE
SSEEEEESSSEEEESSSSEEEFE
EEEGGEEEEEEEEEEEEEEEGGG
EEEGGEEEEEEEEEEEEEEEGGG
EEEGGEEEEEEEEEEEEEEEGGG
EEEGGEEEEEEEEEEEEEEEGGG
